sample_id	seq_path
GPSC10_reference	/vast/palmer/scratch/turner/flg9/snakemake_workflows/pangenome_alignment/pipelines/SP/prokka_roary/GPSCs/GPSC10_reference.fasta
GPSC11_reference	/vast/palmer/scratch/turner/flg9/snakemake_workflows/pangenome_alignment/pipelines/SP/prokka_roary/GPSCs/GPSC11_reference.fasta
GPSC12_reference	/vast/palmer/scratch/turner/flg9/snakemake_workflows/pangenome_alignment/pipelines/SP/prokka_roary/GPSCs/GPSC12_reference.fasta
GPSC13_reference	/vast/palmer/scratch/turner/flg9/snakemake_workflows/pangenome_alignment/pipelines/SP/prokka_roary/GPSCs/GPSC13_reference.fasta
GPSC14_reference	/vast/palmer/scratch/turner/flg9/snakemake_workflows/pangenome_alignment/pipelines/SP/prokka_roary/GPSCs/GPSC14_reference.fasta
GPSC15_reference	/vast/palmer/scratch/turner/flg9/snakemake_workflows/pangenome_alignment/pipelines/SP/prokka_roary/GPSCs/GPSC15_reference.fasta
GPSC16_reference	/vast/palmer/scratch/turner/flg9/snakemake_workflows/pangenome_alignment/pipelines/SP/prokka_roary/GPSCs/GPSC16_reference.fasta
GPSC17_reference	/vast/palmer/scratch/turner/flg9/snakemake_workflows/pangenome_alignment/pipelines/SP/prokka_roary/GPSCs/GPSC17_reference.fasta
GPSC18_reference	/vast/palmer/scratch/turner/flg9/snakemake_workflows/pangenome_alignment/pipelines/SP/prokka_roary/GPSCs/GPSC18_reference.fasta
GPSC19_reference	/vast/palmer/scratch/turner/flg9/snakemake_workflows/pangenome_alignment/pipelines/SP/prokka_roary/GPSCs/GPSC19_reference.fasta
GPSC1_reference	/vast/palmer/scratch/turner/flg9/snakemake_workflows/pangenome_alignment/pipelines/SP/prokka_roary/GPSCs/GPSC1_reference.fasta
GPSC21_reference	/vast/palmer/scratch/turner/flg9/snakemake_workflows/pangenome_alignment/pipelines/SP/prokka_roary/GPSCs/GPSC21_reference.fasta
GPSC22_reference	/vast/palmer/scratch/turner/flg9/snakemake_workflows/pangenome_alignment/pipelines/SP/prokka_roary/GPSCs/GPSC22_reference.fasta
GPSC23_reference	/vast/palmer/scratch/turner/flg9/snakemake_workflows/pangenome_alignment/pipelines/SP/prokka_roary/GPSCs/GPSC23_reference.fasta
GPSC25_reference	/vast/palmer/scratch/turner/flg9/snakemake_workflows/pangenome_alignment/pipelines/SP/prokka_roary/GPSCs/GPSC25_reference.fasta
GPSC26_reference	/vast/palmer/scratch/turner/flg9/snakemake_workflows/pangenome_alignment/pipelines/SP/prokka_roary/GPSCs/GPSC26_reference.fasta
GPSC27_reference	/vast/palmer/scratch/turner/flg9/snakemake_workflows/pangenome_alignment/pipelines/SP/prokka_roary/GPSCs/GPSC27_reference.fasta
GPSC2_reference	/vast/palmer/scratch/turner/flg9/snakemake_workflows/pangenome_alignment/pipelines/SP/prokka_roary/GPSCs/GPSC2_reference.fasta
GPSC30_reference	/vast/palmer/scratch/turner/flg9/snakemake_workflows/pangenome_alignment/pipelines/SP/prokka_roary/GPSCs/GPSC30_reference.fasta
GPSC31_reference	/vast/palmer/scratch/turner/flg9/snakemake_workflows/pangenome_alignment/pipelines/SP/prokka_roary/GPSCs/GPSC31_reference.fasta
GPSC32_reference	/vast/palmer/scratch/turner/flg9/snakemake_workflows/pangenome_alignment/pipelines/SP/prokka_roary/GPSCs/GPSC32_reference.fasta
GPSC33_reference	/vast/palmer/scratch/turner/flg9/snakemake_workflows/pangenome_alignment/pipelines/SP/prokka_roary/GPSCs/GPSC33_reference.fasta
GPSC34_reference	/vast/palmer/scratch/turner/flg9/snakemake_workflows/pangenome_alignment/pipelines/SP/prokka_roary/GPSCs/GPSC34_reference.fasta
GPSC37_reference	/vast/palmer/scratch/turner/flg9/snakemake_workflows/pangenome_alignment/pipelines/SP/prokka_roary/GPSCs/GPSC37_reference.fasta
GPSC3_reference	/vast/palmer/scratch/turner/flg9/snakemake_workflows/pangenome_alignment/pipelines/SP/prokka_roary/GPSCs/GPSC3_reference.fasta
GPSC40_reference	/vast/palmer/scratch/turner/flg9/snakemake_workflows/pangenome_alignment/pipelines/SP/prokka_roary/GPSCs/GPSC40_reference.fasta
GPSC43_reference	/vast/palmer/scratch/turner/flg9/snakemake_workflows/pangenome_alignment/pipelines/SP/prokka_roary/GPSCs/GPSC43_reference.fasta
GPSC47_reference	/vast/palmer/scratch/turner/flg9/snakemake_workflows/pangenome_alignment/pipelines/SP/prokka_roary/GPSCs/GPSC47_reference.fasta
GPSC4_reference	/vast/palmer/scratch/turner/flg9/snakemake_workflows/pangenome_alignment/pipelines/SP/prokka_roary/GPSCs/GPSC4_reference.fasta
GPSC5_reference	/vast/palmer/scratch/turner/flg9/snakemake_workflows/pangenome_alignment/pipelines/SP/prokka_roary/GPSCs/GPSC5_reference.fasta
GPSC6_reference	/vast/palmer/scratch/turner/flg9/snakemake_workflows/pangenome_alignment/pipelines/SP/prokka_roary/GPSCs/GPSC6_reference.fasta
GPSC7_reference	/vast/palmer/scratch/turner/flg9/snakemake_workflows/pangenome_alignment/pipelines/SP/prokka_roary/GPSCs/GPSC7_reference.fasta
GPSC8_reference	/vast/palmer/scratch/turner/flg9/snakemake_workflows/pangenome_alignment/pipelines/SP/prokka_roary/GPSCs/GPSC8_reference.fasta
GPSC9_reference	/vast/palmer/scratch/turner/flg9/snakemake_workflows/pangenome_alignment/pipelines/SP/prokka_roary/GPSCs/GPSC9_reference.fasta
JYGP01	/vast/palmer/scratch/turner/flg9/snakemake_workflows/pangenome_alignment/pipelines/SP/prokka_roary/GPSCs/JYGP01.fasta
NC_017592	/vast/palmer/scratch/turner/flg9/snakemake_workflows/pangenome_alignment/pipelines/SP/prokka_roary/GPSCs/NC_017592.fasta
